11
11

##S########
##.########
##.######.#
##.####...#
##.###....#
##........#
##........#
###....####
###...#####
#########W#
###########
