15
15

##S############
##.############
##.######...###
##.####......##
##.###........#
##...........##
###.......#####
###....########
###...#########
###############
###############
###############
############W##
###############
###############