15
15

###############
##S######...###
##..........###
##.#######....#
##..###########
###.....#######
###......######
###...#########
###...#########
###############
###############
###############
###############
###############
###############
###############