12
12

############
############
#S#===##===#
#.#...||...#
#.#...==.W.#
#.#...T=...#
#.#...==...#
#.#...==...#
#.#...==...#
#.....##...#
############
############