2
15
15

###############
##########S####
##########.####
##.........####
##.#######.####
##.############
##.############
##.############
##.##........##
##.##........##
##.##.....W..##
##.##........##
##...........##
###############
###############