6
8
8

########
####..S#
##======
###....=
###....W
#.#....=
#......#
########