9
12
12

####=#######
##S#=#######
##|=B===####
##.#########
##.#########
##.#########
#######B####
############
############
###|||/////#
#####.....W#
############