2
12
12

############
############
#S#===##===#
#.|...||...#
#.#...==..W#
#.#...==...#
#.#...==...#
#.#...==...#
#.#...==...#
#.....##...B
############
############