5
8
8

########
#S######
#.####B#
#.######
#.##|||#
#.##|W|#
####|||#
########