9
11
11

###########
#B###S#####
###########
#####B#####
#######B###
###########
####B######
###########
#/////////#
#/...W.../#
###########